010001110101
020300002011
0x1002010000
10100101000a
10100101011p
101001010455
001001110000
000001000000
